Missione eroica - I pompieri 2

Paese: Italia
Anno: 1987
Durata: 92 min
Genere: Commedia
Regia: Giorgio Capitani
Soggetto: Franco Marotta, Laura Toscano
Sceneggiatura: Franco Marotta, Laura Toscano
Produttore: Mario Cecchi Gori, Vittorio Cecchi Gori
Fotografia: Sandro D'Eva
Montaggio: Sergio Montanari
Musiche: Bruno Zambrini

Interpreti e personaggi

Paolo Villaggio: Paolo Casalotti
Lino Banfi: Nicola Ruoppolo
Massimo Boldi: Max Pirovano
Christian De Sica: Alberto Spina
Teo Teocoli: Pullini
Luc Merenda: Comandante McFarland
Franca Gonella: Roberta
Claudio Boldi: fruttivendolo
Corrado Olmi: Comandante
Franca Scagnetti: ostessa della trattoria
Clarita Gatto proprietaria osteria

Trama

La Squadra 17 torna in azione, guidata ora da Ruoppolo (Lino Banfi) e composta inoltre da Casalotti (Paolo Villaggio), Spina (Christian De Sica), Pirovano (Massimo Boldi) e Pullini (Teo Teocoli), ma la piu sgangherata squadra di pompieri della caserma "Settecamini" non ha perso il vizio di combinare guai.

Quando, a seguito di un gemellaggio fra i Vigili del Fuoco italiani e le forze speciali dei pompieri canadesi, arriva a Roma il Comandante McFarland (Luc Merenda), la Squadra 17 viene scelta da McFarland - dopo aver assisto all'ennesimo fallimento dei 5 nell'impresa di salvare delle persone da un'alluvione - per essere da lui personalmente addestrata. Mentre McFarland sottopone i 5 ad un pesantissimo addestramento, un pozzo petrolifero prende fuoco ed il Comandante, esperto nel settore, accetta d'intervenire, utilizzando pero la Squadra 17 per la missione - che prevede l'utilizzo di un carico di nitroglicerina per spegnerlo - seppur col parere contrario del comandante della caserma. McFarland pero fa credere ai 5 che si tratti di una normale esercitazione e, prendendo la cosa sottogamba, credendo che il carico non contenga realmente nitroglicerina, finiscono per far saltare in aria l'intero camion. I 5 fanno credere al comando che il carico sia stato sabotato, ma McFarland non demorde e riaffida ai 5 la missione, stavolta dividendo il carico su due camion perche almeno uno deve arrivare a destinazione, e decide di seguirla personalmente, obbligando i 5 a seguire percorsi alternativi tra paludi e foreste per depistare i presunti sabotatori. Durante la notte si assiste anche al tentativo di fuga di Spina e Pullini, che pero la mattina dopo si ritroveranno al punto di partenza, in tempo per evitare che Pirovano e Casalotti finiscano sotto il camion guidato maldestramente da Ruoppolo nel tentativo di liberarli dal fango. Dopo varie peripezie i 5 raggiungono il pozzo credendo che la loro missione sia finita, ma McFarland ha previsto che siano 2 di loro a gettare la nitroglicerina nel pozzo, rischiando la vita. Dopo una surreale conta i prescelti sono Casalotti e Pirovano, ma quando i 2 rischieranno di essere ingoiati dalle fiamme gli altri 3 interverranno per salvarli, riuscendo a spegnere il fuoco, con Casalotti che riuscira pure a mandare a quel paese McFarland, vincendo una scommessa con Spina, e il tutto si conclude con la Squadra 17 portata in trionfo.

Video: DivX 5 600x350 25.00fps
Bit rate: 944 Kbps
Aspect ratio: 16:9
Audio: MPEG Audio Layer 3 44100Hz stereo
Bit rate: 106 Kbps
Language: Italian
Subtitles: None
  
http://www.imdb.com/title/tt0126443/